XXXXXXXXXX
XPOOOOOOOX
XOOOOOOOOX
XOOOOOOOOX
XOOAOOBOOX
XOOOOOOOOX
XOOCOODOOX
XOOOOOOOOX
XOOOOOOOOX
XXXXXXXXXX
