XXXXXXXXXX
XOOOOOOOOX
XOOOOAOOOX
XOOXOOXOOX
XOOCOPOBOX
XOOXOOXOOX
XOOOODOOOX
XOOXXXXOOX
XOOOOOOOOX
XXXXXXXXXX
