XXXXXXXXXXXX
XPOOOOOOOOAX
XOXXXXXXOOOX
XBOOOOOOOOCX
XOOXXXXXXOOX
XDOOOOOOOOOX
XXXXXXXXXXXX

