XXXXXXXXXX
XOOCOOOOBX
XOXXOOXOOX
XOOOOOOXOX
XOXXPXOOOX
XOOXOXOXOX
XOOOAOOODX
XOOOXXOOOX
XOOOOOOOOX
XXXXXXXXXX