XXXXXXXXXX
XPAOOOOOOX
XOOOOOOOOX
XOOBOCOODX
XOOOOOOOOX
XOOOOOOOOX
XOOOOOOOOX
XOOOOOOOOX
XOOOOOOOOX
XXXXXXXXXX
